1111111111111111111111111111111111111111111111111111111111111111
1111111111111111000000000000022222222000000000011111111111111111
1111111111122000000000000000022222222000000000111111111111111111
1111111111222200000060000000002222222006000001113333311111111111
1111111122222222000006000000000022200000000011333333333311111111
1111111122222222200000000000000000000000000113333333333333333111
1111110122222222220000000000000000000000001133333333333333333311
1111000112222222220000000000000000000000011333333333333355333311
1100000011222222220000000000000000000000113333333333333333333311
1100000001222222222000000000000000000014133333333333333333333111
1100000001122222200000060000000000111113333333333333333333333111
1100000000111122000000606000000011111133333333333533333333333111
1110000000000000000000600000000001111333333333335353333333333111
1110000000000000000000000000000000111333333333333333333333331111
1111000000000000000000000000000000001333333333333333333333311111
1111000000000000000000000000000000001113333333333333333333333311
1110000000000000000000000000000000001111133333333333333333333311
1100006000000000000000000000000000001111133333333333333333333311
1100060600000000000022200000000000000011133333333333333333533311
1100000000000000222222222220000006000000111113333333333335353311
1100000000000002222222222200000066600000000011111133333333333111
1110000000000000222222222200000000000000000000000114111333333311
1110000000000000222222222000000000000000000000000000001133333111
1111000000000022222222222200000000000000000000000000000113331111
1111000000000000222222200000000000000000000000000000000011333111
1100000000000000002222000000000000000000000000000000000001111111
1100000000000000000220000000000000000000000000000000000000000071
1100220000000000000000006000000000000000000000000000000000000011
1122222222000000000000060000000000000000022002000000000000000111
1112222222000000000000000000000000000022222222220000066000001111
1111222222220000000000000000000000000222222222220000666600011111
1111222222222000000000000000000000002222222222220000666600000111
