0000000000000000000000000000000000000000000000000000000000000011
0000000000000000000000000000000000000000000000000000000000000011
0000000000000000000000000000000000000000000000000000000000000011
0000000111111111111001001011111111100001111111100001111111110011
1000000000000100000000000010000000000001000000000000000100000011
0100000000000100000000000010000000000001000000000000000100000011
1000000000000100000000000011111111100001111111100000000100000011
0100000000000100000000000010000000000000000000100000000100000011
0000000000000100000000000011111111100000000000100000000100000011
0000000000000000000000000000000000000001111111100000000000000101
0000000000000000000001111111111111111111000000000000000000000101
0000000000000000000001111111111111111111000000000000000000000101
0000000000000000000001111111111111111111000000000000000000000101
0000000000000000000001111111111111111111000000000000000000000001
0000000000000000000001111111111111111111111111111111111111111111
0000000000000000000001000000000000000001000000000000000000000001
0000000000000000000001000000000000000001000000000000000000000001
0000000000000000000001111111111111111111000000000000000000000001
0000000000000000000000000000000000000000000000000000000000000001
0000000000000000000000000000000000000000000000000000000000000001
0000000000000000000000000000000000000000000000000000000000000001
0000000000000000000000000000000000000000000000000000000000000001
0000000000000000000000000000000000000000000000000000000000000001
0000000000000000000000000000000000000000000000000000000000000001
0000000000000000000000000000000000000000000000000000000000000001
0000000000000000000000000000000000000000000000000000000000000011
0000000000000000000000000000000000000000000000000000000000000011
0000000000000000000000000000000000000000000000000000000000000011
0000000000000000000000000000000000000000000000000000000000000111
0000000000000000000000000000000000000000000000000000000000001111
0000000000000000000000000000000000000000000000000000000000011111
0000000000000000000000000000000000000000000000000000000001111111