1111111111111111111111111111111111111111111111111111111111111111
1111111111111111111111111111111111111111111111111111111111111111
1111111111111111111111111111111111111111111111111111111111111111
1111111111111111112220601111111111111111111111111111111111111111
1111111111111112222220060111111133533311111111111111111111111111
1111111111111122222200000011111135333333311111111111111111111111
1111111111111122200000000011111133333333333111111111111111111111
1111111111111222200011114111111333333333333111111111111111111111
1111111111111122001111114111100333333333333111111111111111111111
1111111111111220011111100000000333333353333111111111111111111111
1111111111111111111110000000000333333553333111111111111111111111
1111111111111111111110000000000000033333333111111111111111111111
1111111111111111111106000111100222033333333111111111111111111111
1111111111111111111060001111002220033333331111111111111111111111
1111111111111111100000111111000220033333331111111111111111111111
1111111111111111100002111110000000033333331111111111111111111111
1111111111111111000202211110000000333331111111111111111111111111
1111111111111111000222111220600000333331111111311111111111111111
1111111111111100000222112206600000033331111113331111111111111111
1111111111111100002221122000000000033311111133333111111111111111
1111111111111100222211222000000000131413333133353111111111111111
1111111111111100221112222000000001111333333335533111111111111111
1111111111111141111222222000101111113333333335331111111111111111
1111111111111000222222222011111111111133333353311111111111111111
1111111111111000022222000111111111111111333111111111111111111111
1111111111111100002220000111111111111111111111111111111111111111
1111111111111110000020001111111111111111111111111111111111111111
1111111111111111100001111111111111111111111111111111111111111111
1111111111111111100011111111111111111111111111111111111111111111
1111111111111111111111111111111111111111111111111111111111111111
1111111111111111111111111111111111111111111111111111111111111111
1111111111111111111111111111111111111111111111111111111111111111
