1111111111111111111111111111111111111111111111111111111111111111
1111111111111111111111111111111111111111111111111111111111111111
1111111111111111111111111111111111111111111111111111111111111111
1111111111111111111111111111111111111111111111111111111111111111
1111111111111111111111111111111111111111111111111111111111111111
1111111111111111111111111111111111111111111111111111111111111111
1111111111111111111111111111111111111133333711111111111111111111
1111111111111111111111111111111111111333353111111111111111111111
1111111111111111111111111111111111111335533311111111111111111111
1111111111111111111111111111111111111335353331111111111111111111
1111111111111111111111111111111111111333333331111111111111111111
1111111111111111111111111111111111111333333311111111111111111111
1111111111111111111111111111000000111133333111111111111111111111
1111111111111111111111110000006600001113331111111111111111111111
1111111111111111111111100000000000001114111111111111111111111111
1111111111111111111111000000011100000114111111111111111111111111
1111111111111111111111000000111100000000111111111111111111111111
1111111111111111111110660001111100000000011111111111111111111111
1111111111111111111110660011111100000060011111111111111111111111
1111111111111111111110060011111110000000011111111111111111111111
1111111111111111111110000001110100000000011111111111111111111111
1111111111111111111110000000110000000011111111111111111111111111
1111111111111111111111000000000000000111111111111111111111111111
1111111111111111111111100000000006601111111111111111111111111111
1111111111111111111111110000000060601111111111111111111111111111
1111111111111111111111111111100000001111111111111111111111111111
1111111111111111111111111111111111111111111111111111111111111111
1111111111111111111111111111111111111111111111111111111111111111
1111111111111111111111111111111111111111111111111111111111111111
1111111111111111111111111111111111111111111111111111111111111111
1111111111111111111111111111111111111111111111111111111111111111
1111111111111111111111111111111111111111111111111111111111111111
